##########
#P#1  ##C#
# # # ##1#
#1# #  # #
#   #C   #
#####    |
#C 1     #
#######1##
#L 1    C#
##########