||||||||||
|C|1  ||C|
| | | ||1|
|1| |  | |
|   |C   |
|||||  P |
|C 1     |
|||||||1||
|C 1     |
||||||||||