########################
#L   C###      2########
#   2 ######### ########
#####3######### ####   |
#   #           ####2###
#P  ####### ####     ###
#  ######## #### ### ###
# ##C###### 2 C#  ## ###
#1##2###### ####C ## ###
#  # ###### ##### ##2###
# #            ## ##   #
#   C#########    ##  C#
########################