########################
#L   C###       ########
#  1  ######### ########
#####1######### ####   |
#   #           ####1###
#P  ####### ####     ###
#  ######## #### ### ###
# ##C###### 1 C#  ## ###
#1##1###### ####C ## ###
#  # ###### ##### ##1###
# #            ## ##   #
#   C#########    ##  C#
########################